##################
# s #   f#       #
#   #  ###  ###  #
### #  #      #  #
#   #  #      #  #
#                #
##################